  ###################
      # # # #     # #
# ### # # # # ### # #
#   # #         #   #
##### # ##### ### ###
#   # # # #     #   #
### # # # # # # #####
# # #     # # #     #
# # # # # # ##### # #
#     # # # #     # #
####### ### ####### #
#         # # # # # #
##### ####### # # ###
#         # #   #   #
##### ### # # ### ###
#   # #   #         #
# ##### ### ####### #
#   #         # #   #
# ##### # # # # # ###
#       # # #   #   #
################### #
